1111111111111111111111111111111111
1E0000000000000C00000C000000000001
1010010100100000101001000000010101
1010010010101010001001001100010111
100000000C00C0000000000011000000C1
1P00011100000011111100001101111001
1000000000C00000000000000000C00001
1111111111111111111111111111111111